*********************************
*     **********************    *
*   *******   D.   **********   *
*   *******    ....             *
* ****************.   ***********
************.......   ********  *
*           .********************
* ********  . *******************
*********   .               *****
******      .************       *
****        .......*********    *
**      ******    . *************
******************.      ********
****      ****   ..       ***** *
*                .              *
*                s              *
*********************************
